000000000000000000000000000000000000000000000000000000000000000000000000000000000000000000000000000000000000000000000000000000000000000000000
000000000000000000000000000000000000000000000000000000000000000000000000000000000000000000000000010001000100000000000000000000000000000000000
000000000000000000000000000000500000000000000000001000100000000000011100000000000000000000000000000000000000000000000000000000000000000000000
000000000000000000000000000000000000000000000100000000000000000000000000000000000000000000000000000000000000000000000000000000000000000000000
000000000000000001000001000001100000000000000000000000000000000000000000000003000000000000000001000000000000000000000000000000000000000000000
000000000011000000000000000000000000000001000000000000000010000000000000000111100000000000000000000000000000000000000001110000000000000000000
000000000000000000000000000000000001000000000000005000000000000000000000000000500000000100000000000000000000000001000005000000000090000000000
000000000000000000003000000000000040000000000000000000030000000004000000000000000000000000000000100000000000000000000000000000000000000000000
222211111111111221111111122211111111221111111111111111111221111111111111111111111111111211111111111122222222211111111111111111111111111111111