000000000000000000040000000000000000000000000000000000000000000000000000000003000000000000000010000000000000000000000000000000000000000000000000000000
000000000000000000110000000000000000000000000010000000000000000010001000100011000000000000000000000010000000000000000000030030000000000000000000000000
000000000000000000000000000000000000000010000000100000000000000000000000000000000000000001000000000000000000000000000000111111000000000000000000000000
000000000000011000000000000100000000000110000000000000000000000000000000000000000000000000000000000000000000000000000000000000000000000000000000000000
000000000000000000110000000000000300000000000000000000000011000000000000000000000000100000000100000000000000000000110000000000000001100000000000000000
000000001100000000000000010000001110000000000000000001000000000000000000000000010000000000000000000000001000000000000000000000000000010000000000000000
000000000000000000000000000000000000000000000000000000000000001000000000000000000000000100000000000100000000000000000000110000000000000000090000000000
000000000000000000000040000000000001000000000000000000000004000000000000000000000000040000000000000000000000000000000000400000000000000000000000000000
222211112222222222221112222222221111222221112212212221111221111222222222222222222111112222221112221112211111222211111111112222222221111111111111111111