000000000000000000000000000000000000000000000000000000000000000000000000000000000000000000000000000000000000000000000000000000000000000000000000000000000000000000000000000000000
000000000000000000000000000000000000000000000000000000000000000000000000000000000000000000000000000000000000000000000000000000000000000000000000000000000000000000000000000000000
000000000000000000000000000000000000000000000000000000000000000000000000000000000000000000000000000000000000000000000000000000000000000000000000000000000000000000000000000000000
000000000000000000000000000000000000111100000000400000000000000000000000000000000000000000000000000000000000111000000000000000000000100000000000000000000000000000000000000000000
000000000000000000000000000000000000000000000111111000000000000000000000000000000000000000000000000000000000000000000000000000000000000000000000000000000000011000000000000000000
000000000010000000000000000001111000000000000000000000000000000000000000011000000000000000000000000001110000000000001110000000001000000000000000000000111000011100000000000000000
000000000000000000000000000000000000000000000000000000010000000000000000000000000000010000000000000000000000000000000000000000000000000000000000000000000000011110000090000000000
003000000000300000000004000000004000300000000030000000000000003000040000000304000000114000000030000000000000444000000000000001000000004300000000040000000030011111000000000000000
222211111111211112221111111111111222222222222222221111111111112111111111122211111111111112221121111111111111111111111111111111111111111212222111111111122222211111111111111111111