0000000000000000000000000000000000000000000000000000000000000000000000000000000000000000000000000000000000000000000000000000000000000000000000000000000000000
0000000000000000000000000000000011111100000000000000000000000000000000000000000000000000000000000000000000000000000000000000000000000000000000000000000000000
0000000000000000000000001110000000000000000000000000000110000000000000003000000000000000000000000000000000000000000000000101000100000003000000000000000000000
0000000000000000000000000000000000000000000000000000000000000000000000111111000000000000000000001000000000000000000000010000000000000111000000000000000000000
0000000000000000000000000000000000000000000000000000000000000000001000000000000000000000000013330000000000000000000000000000000000000000000000000000000000000
0000000000100000000000000000000000000000000000110000000000000000100000000000000000000000001000000000000000010000000100000000000000000000000000000000000000000
0000000000400004000011000000100000000000000011000004000000000110000000000000000004000001000000000000011000000000001140000000000000000000000000000090000000000
0000000000030000000000000003330000000000000000000000000000000000000000000000000000000000000000000000000003333000011100000000300003000000000030000000000000000
2222112221111111111111111111111111111111111122211111111111221111111111112221111111111111222111111112222111111111111111122211111111111111111111111111111111111