000000000000000000000000000000000000000000000000000000000000000000000000000000000000000000000000000000300000000000000000000000000000000000000000000000000000000000
000000000000000000000000000000000000000000000000000000000000300000000000000000000000000000000001000011111000000000000000000000000010000000000000000000000000000000
000000000000000000000100000000000011000000000000000000000001110000000000000000000000000000000000000000000000000000000001000000000000000000000000000000000000000000
000000000000000000000000000000000000000000000000000000001000000000000000000000000000000000000000000000000000000000000000000001000000001000000000000000000000000000
000000000000000001100000111000000000000001000000000000000000000000100000111100000000000000001000000000000000000000100000000000000000000000000000100000000000000000
000000000011100000000000000000100000000001000001000000100000000000000000000000000000100000000000000000000001000000000000010000000100000000001000000000000000000000
000000000000000000000000000000000000000001000000000000000000000000000000000000000000000000000001000000000000000000000100000001000000000000000000000000090000000000
004000000000030010000000000400000000000001000000000003000000004000003000000000000030000000000000000000000000000000000000000000300000010000004000000000000000000000
222211111111112211111111111222111111111111111111111111111111112222221111111111111112211111111111111122222211111111111111111111111111111111112221111111111111111111